6 7
1 1 1 1 1 1 1
1 1 1 0 0 0 1
1 1 1 9 1 0 1
1 1 1 1 1 0 1
1 5 0 0 0 0 1
1 1 1 1 1 1 1
step 1
turn right
# 试试看，如何拿到宝箱