15 19
1 1 1 1 1 1 1 1 1 1 1 1 1 1 1 1 1 1 1
1 5 0 0 0 0 0 0 0 1 0 0 0 0 0 0 0 0 1
1 1 0 1 1 1 1 1 0 1 0 1 1 1 1 1 0 1 1
1 1 0 0 0 1 0 0 0 1 0 0 0 0 0 1 0 1 1
1 1 1 1 1 1 0 1 0 1 1 1 0 1 1 1 0 1 1
1 1 0 0 0 1 0 1 0 0 0 1 0 1 0 0 0 1 1
1 1 0 1 0 1 0 1 0 1 1 1 0 1 1 1 3 1 1
1 1 0 1 0 1 0 1 0 1 0 0 0 1 0 0 0 0 1
1 1 0 1 0 1 0 1 1 1 0 1 1 1 0 1 0 1 1
1 1 0 1 0 0 0 1 0 0 0 1 0 0 0 1 0 0 1
1 1 0 1 1 1 1 1 0 1 1 1 1 1 0 1 1 1 1
1 1 0 1 0 0 0 1 0 1 0 0 0 1 0 0 0 0 1
1 1 0 1 0 1 0 1 0 1 0 1 0 1 1 1 0 1 1
1 1 0 0 0 1 0 0 0 0 0 1 0 0 0 0 0 9 1
1 1 1 1 1 1 1 1 1 1 1 1 1 1 1 1 1 1 1
# 教程结束，开始你的挑战吧