6 5
1 1 1 1 1
1 0 5 0 1
1 0 0 0 1
1 0 0 0 1
1 0	9 0 1
1 1 1 1 1
step 2
# 你能修改代码，成功拿到宝箱吗？