5 5
1 1 1 1 1
1 3 0 5 1
1 0 3 0 1
1 9 0 0 1
1 1 1 1 1
step 2
turn left
step 2
# 小心地图上有陷阱，不要掉进去哦