5 5
1 1 1 1 1
1 0 0 0 1
1 0 3 0 1
1 5 3 9 1
1 1 1 1 1
step 2
turn left




# 试试看，怎么拿到宝物