5 5
1 1 1 1 1
1 0 0 0 1
1 0 3 0 1
1 9 3 5 1
1 1 1 1 1
3.times ->
    

# 亲自试试吧，加油
# 注意循环语句内部需要四个空格